disorganized	неорганизованный_ADJ
devious	нечестный_ADJ
impressionable	впечатлительный_ADJ
circumspect	бдительный_ADJ
impassive	бесстрастный_ADJ
effeminate	слабый_ADJ
unfathomable	непостижимый_ADJ
fickle	непостоянный_ADJ
unprincipled	беспринципный_ADJ
inoffensive	безобидный_ADJ
providential	удачный_ADJ
resentful	обидчивый_ADJ
impractical	непрактичный_ADJ
sarcastic	саркастический_ADJ
misguided	неправильный_ADJ
imitative	подражать_VERB
pedantic	педантичный_ADJ
venomous	злой_ADJ
erratic	непредсказуемый_ADJ
insecure	неуверенный_ADJ
resourceful	сообразительный_ADJ
neurotic	нервный_ADJ
forgiving	великодушный_ADJ
profligate	расточительный_ADJ
whimsical	капризный_ADJ
assertive	настойчивый_ADJ
incorruptible	неподкупный_ADJ
individualistic	эгоистичный_ADJ
faithless	предательский_ADJ
barbaric	варварский_ADJ
vindictive	мстительный_ADJ
observant	внимательный_ADJ
dissolute	развратный_ADJ
frightening	пугать_VERB
complacent	самодовольный_ADJ
boisterous	неистовый_ADJ
disobedient	непослушный_ADJ
tasteless	пошлый_ADJ
sedentary	сидячий_ADJ
sophisticated	утонченный_ADJ
mellow	мягкий_ADJ
deceitful	лживый_ADJ
sociable	общительный_ADJ
willful	упрямый_ADJ
idealistic	идеалист_NOUN
boyish	мальчишеский_ADJ
callous	бессердечный_ADJ
pompous	высокопарный_ADJ
unchanging	неизменный_ADJ
crafty	коварный_ADJ
punctual	своевременный_ADJ
intolerant	раздражительный_ADJ
challenging	смелый_ADJ
scornful	презрительный_ADJ
possessive	властный_ADJ
conceited	самолюбивый_ADJ
imprudent	неосторожный_ADJ
dutiful	послушный_ADJ
lovable	привлекательный_ADJ
disloyal	неверный_ADJ
dreamy	мечтательный_ADJ
appreciative	признательный_ADJ
forgetful	забывчивый_ADJ
unrestrained	невоспитанный_ADJ
forceful	убедительный_ADJ
submissive	покорный_ADJ
predatory	хищный_ADJ
fanatical	фанатичный_ADJ
illogical	противоречивый_ADJ
tidy	аккуратный_ADJ
aspiring	стремиться_VERB
studious	старательный_ADJ
adaptable	гибкий_ADJ
conciliatory	примирительный_ADJ
artful	ловкий_ADJ
thoughtless	беспечный_ADJ
deceptive	лжец_NOUN
frugal	экономный_ADJ
reflective	мыслящий_ADJ
insulting	оскорбительный_ADJ
unreliable	ненадежный_ADJ
stoic	мужественный_ADJ
hysterical	истеричный_ADJ
rustic	простоватый_ADJ
inhibited	замкнутый_ADJ
outspoken	откровенный_ADJ
unhealthy	нездоровый_ADJ
skeptical	скептический_ADJ
painstaking	кропотливый_ADJ
contemplative	созерцать_VERB
leisurely	неторопливый_ADJ
sly	хитрый_ADJ
mannered	вычурный_ADJ
outrageous	жестокий_ADJ
lyrical	лирический_ADJ
placid	безмятежный_ADJ
cynical	циничный_ADJ
irresponsible	безответственный_ADJ
vulnerable	уязвимый_ADJ
arrogant	высокомерный_ADJ
steadfast	непреклонный_ADJ
crisp	хрупкий_ADJ
envious	завистливый_ADJ
naive	наивный_ADJ
greedy	жадный_ADJ
presumptuous	самонадеянный_ADJ
obnoxious	неприятный_ADJ
discreet	сдержанный_ADJ
sporting	спортивный_ADJ
hateful	ненавистный_ADJ
ungrateful	неблагодарный_ADJ
frivolous	легкомысленный_ADJ
reactionary	резкий_ADJ
skillful	искусный_ADJ
cowardly	трусливый_ADJ
sordid	противный_ADJ
adventurous	рискованный_ADJ
dogmatic	догматик_NOUN
intuitive	интуитивный_ADJ
bland	банальный_ADJ
indulgent	снисходительный_ADJ
discontented	недовольный_ADJ
articulate	красноречивый_ADJ
discouraging	унылый_ADJ
treacherous	предатель_NOUN
repressed	скованный_ADJ
moody	угрюмый_ADJ
sensual	чувственный_ADJ
unfriendly	недружелюбный_ADJ
optimistic	оптимистичный_ADJ
clumsy	неуклюжий_ADJ
contemptible	презренный_ADJ
focused	собранный_ADJ
haughty	заносчивый_ADJ
morbid	болезненный_ADJ
disorderly	беспорядочный_ADJ
humorous	юмористический_ADJ
preoccupied	озабоченный_ADJ
impersonal	беспристрастный_ADJ
cultured	образованный_ADJ
trusting	доверчивый_ADJ
respectful	почтительный_ADJ
scrupulous	тщательный_ADJ
scholarly	ученый_NOUN
superstitious	суеверный_ADJ
tolerant	терпимый_ADJ
realistic	реалистический_ADJ
malicious	злобный_ADJ
irrational	нерациональный_ADJ
sane	разумный_ADJ
colorless	неприметный_ADJ
masculine	мужской_ADJ
witty	остроумный_ADJ
inert	инертный_ADJ
prejudiced	предвзятый_ADJ
fraudulent	жулик_NOUN
blunt	тупой_ADJ
childish	ребяческий_ADJ
disciplined	дисциплинированный_ADJ
responsive	чуткий_ADJ
bewildered	озадаченно_ADV
courteous	учтивый_ADJ
aloof	неприветливый_ADJ
sentimental	сентиментальный_ADJ
extravagant	неумеренный_ADJ
brutal	зверский_ADJ
cooperative	приветливый_ADJ
unstable	неустойчивый_ADJ
youthful	юношеский_ADJ
timid	робкий_ADJ
amiable	любезный_ADJ
retiring	застенчивый_ADJ
confidential	надежный_ADJ
relaxed	спокойный_ADJ
imaginative	творческий_ADJ
mystical	мистический_ADJ
shrewd	проницательный_ADJ
conscientious	добросовестный_ADJ
monstrous	чудовищный_ADJ
grim	мрачный_ADJ
lazy	ленивый_ADJ
dynamic	активный_ADJ
gloomy	хмурый_ADJ
troublesome	проблема_NOUN
abrupt	грубый_ADJ
dignified	благородный_ADJ
hearty	сердечный_ADJ
benevolent	благожелательный_ADJ
maternal	материнский_ADJ
paternal	отеческий_ADJ
patriotic	патриотический_ADJ
aggressive	агрессивный_ADJ
competitive	соревноваться_VERB
elegant	элегантный_ADJ
gracious	милостивый_ADJ
energetic	энергичный_ADJ
tough	жесткий_ADJ
cautious	осторожный_ADJ
polished	изысканный_ADJ
sage	мудрый_ADJ
tense	напряженный_ADJ
caring	заботливый_ADJ
suspicious	подозрительный_ADJ
sober	трезвый_ADJ
disturbing	тревожный_ADJ
passionate	страстный_ADJ
crazy	псих_NOUN
fearful	испуганный_ADJ
daring	отважный_ADJ
prudent	предусмотрительный_ADJ
demanding	требовательный_ADJ
impatient	нетерпеливый_ADJ
cerebral	рассудительный_ADJ
calculating	расчетливый_ADJ
amusing	забавный_ADJ
honorable	почтенный_ADJ
casual	обычный_ADJ
sharing	щедрый_ADJ
ruined	испортить_VERB
spontaneous	спонтанный_ADJ
admirable	замечательный_ADJ
conventional	общепринятый_ADJ
cheerful	веселый_ADJ
solitary	уединенный_ADJ
upright	честный_ADJ
enthusiastic	восторженный_ADJ
petty	ничтожный_ADJ
dirty	грязный_ADJ
subjective	субъективный_ADJ
heroic	героический_ADJ
stupid	дурной_ADJ
modest	скромный_ADJ
impressive	впечатляющий_ADJ
orderly	опрятный_ADJ
ambitious	честолюбивый_ADJ
protective	покровительственно_ADV
silly	глупый_ADJ
destructive	разрушительный_ADJ
exciting	увлекательный_ADJ
crude	примитивный_ADJ
ridiculous	чудаковатый_ADJ
mature	зрелый_ADJ
passive	пассивный_ADJ
oppressed	угнетенный_ADJ
accessible	доступный_ADJ
charming	обаятельный_ADJ
clever	умный_ADJ
decent	порядочный_ADJ
miserable	несчастный_ADJ
superficial	поверхностный_ADJ
stern	суровый_ADJ
emotional	эмоциональный_ADJ
rigid	косный_ADJ
invisible	незаметный_ADJ
desperate	отчаянный_ADJ
romantic	романтик_NOUN
agreeable	приятный_ADJ
hurried	поспешный_ADJ
sympathetic	симпатичный_ADJ
solemn	торжественный_ADJ
systematic	систематический_ADJ
vague	непонятный_ADJ
peaceful	мирный_ADJ
humble	смиренный_ADJ
expedient	целесообразный_ADJ
loyal	лояльный_ADJ
decisive	решительный_ADJ
arbitrary	произвольный_ADJ
earnest	серьезность_NOUN
confident	уверенный_ADJ
conservative	консервативный_ADJ
moderate	умеренный_ADJ
helpful	полезный_ADJ
delicate	деликатный_ADJ
gentle	нежный_ADJ
dedicated	преданный_ADJ
hostile	враждебный_ADJ
precise	точный_ADJ
healthy	здоровый_ADJ
artificial	искусственный_ADJ
progressive	прогресс_NOUN
odd	странный_ADJ
confused	смущенный_ADJ
rational	рациональный_ADJ
brilliant	гениальный_ADJ
intense	пылкий_ADJ
genuine	подлинный_ADJ
mistaken	ошибочный_ADJ
driving	движущий_ADJ
stable	прочный_ADJ
objective	объективный_ADJ
sensitive	чувствительный_ADJ
neutral	нейтральный_ADJ
strict	строгий_ADJ
profound	глубокомысленный_ADJ
ignorant	невежественный_ADJ
logical	логичный_ADJ
extraordinary	необычный_ADJ
experimental	любознательный_ADJ
formal	формальный_ADJ
curious	любопытный_ADJ
busy	занятый_ADJ
liberal	либеральный_ADJ
friendly	дружелюбный_ADJ
efficient	эффективный_ADJ
sweet	милый_ADJ
surprising	удивительный_ADJ
mechanical	механический_ADJ
clean	чистый_ADJ
critical	критический_ADJ
criminal	преступный_ADJ
proud	гордый_ADJ
quiet	тихий_ADJ
solid	твердый_ADJ
complex	сложный_ADJ
grand	величественный_ADJ
warm	теплый_ADJ
slow	медленный_ADJ
false	ложный_ADJ
extreme	крайний_ADJ
narrow	ограниченный_ADJ
dependent	зависимый_ADJ
organized	организованный_ADJ
directed	целенаправленный_ADJ
obvious	очевидный_ADJ
popular	популярный_ADJ
capable	способный_ADJ
secure	безопасный_ADJ
independent	независимый_ADJ
practical	практичный_ADJ
serious	серьезный_ADJ
fair	справедливый_ADJ
constant	статичный_ADJ
responsible	ответственный_ADJ
religious	религиозный_ADJ
simple	простой_ADJ
physical	физический_ADJ
original	оригинальный_ADJ
working	работящий_ADJ
strong	сильный_ADJ
modern	современный_ADJ
determined	определенный_ADJ
open	открытый_ADJ
political	политический_ADJ
difficult	трудный_ADJ
knowledge	знание_NOUN
kind	добрый_ADJ
